%%%%%%%%%%%%%%%%%%%%%%%%%%%%%%%%%%%%%%%%%
%       %.....%       % %     % %   % % %
% % %%% %.%%%.%%% %%%%% % %%%%% % %%% % %
% %   % %...%...%...%.....  % %.....    %
%%%%%%% %%%.%%%.%.%.%.% %.%%% %.%%%.% % %
%.  %.......  %...%.%.% %.%.....%.%.% % %
%.%%%.% %%% %%%%%%%.%.%%%.%.%%%%%.%.%%% %
%.%...%   %   %.%...%...%...%.%.....%   %
%.%.%%% % %%%%%.%.%%%%%.%%%%%.%%%.%%%%%%%
%...%   % %.....%.%.....%...%.......%...%
%%%.%%%%%%%%%.%%%.%.%%%.%%%.%%%%%%%.%%%.%
%.....%.%   %.....%.%.%.%.%.........%...%
%%%%%.%.% %%%%%%%.%.%.%%%.%%%.%%%.%%%.%.%
%.%...%...  %   %...%...........%.%...%.%
%.%.%%%.%.%%% %%%%%%%%%.%%%%%%%.%%%.%%%%%
%.......%...  %       %.%.....%...%.....%
%.%%%%%%%%%.%%%%% %%%%%.%%%%%.%.%.%%%.%%%
%.%...%.%.....    % % %...%...%.%.....% %
%.%.%.%.%%%%%.%%%%% % %%%.%.%.%%%.%.%%%%%
%.%.%.......%...% %     %.%.......%.%.%.%
%.%.%%%.%.%%%.%%% %%%%% %.%.%%%.%.%%%.%.%
%...%.%.%.%.......%   % %.%...%.%.%.....%
%%%.%.%%%%%%%%%.%%% %%% %.%%%.%%%%%%%.%%%
%.....%.%...%.......    %...%...........%
%%%.%.%.%.%%%.%%%.%%%%% %.%.%%%%%%%%%%%.%
%...%.%...%.....%...%   %.%.......%.....%
%%%.%%%.%%%%%.%.%%%.% %%%.%.%%%%%.%%%.%.%
%.....%...%.......%.%   %.%.%.%.%.....%.%
%.%.%.%.%%%%%.%.%%%%%%%%%%%.%.%.%%%%%%%.%
%.%.%.%.....%.%...........%...%.......%.%
%.%%%.%%%.%.%%%%%.%.%%%%%.%%%.%.%.%%%%%%%
%...%.%...%.......%.%...%...%...%.....%.%
%.%%%%%%%.%%%%%.%%%%%.%.%%%.%%%.%%%.%.%.%
%...%.....%   %.%.....%.....  %.%...%...%
%.%.%%%%%%%%%%%.%.% %%%%%.% % %.%%%%%.%%%
%.%...%...    %.%.%     %.% % %...%.....%
%.%%%%%.%.%%%%%%%.%%% %%%%%%% %%%.%.%%%.%
%...%...%...  %...%   %     % %...%.%.%.%
%%%%%.% %%%.%%%%%.%%%%% %%% % %%%.%.%.%%%
%.....% %.........        % %   %.%.....%
%%%%%%%%%%%%%%%%%%%%%%%%%%%%%%%%%%%%%%%%%
