%%%%%%%%%%%%%%%%%%%%%%%%%%%%%%%%%%%%%%%%%
%.%...........%             %           %
%.%%%%%.%%%%%.%%% %%%%% %%% % %%% %%%%%%%
%.......  %  ...    %   %       %       %
%%%%%%%%% %%%%%.%%%%%%% % % %%%%%%%%% %%%
%     %     %...%.        %     %   %   %
% %%% % %%% %.%%%.%%%%%%%%% %%%%% %%%%% %
%   %     % %.............  %         % %
% % %%% %%%%%%% %%%%%%%%%.%%% % %%%%%%% %
% %   %     %     %   %...%   %         %
%%% %%%%%%%%%%%%%%% % %.%%% %%%%%%%%%%%%%
%     %         %   % %.  %             %
%%% %%%%% %%%%% % % %%%.%%%%%%%%%%%%%%% %
%   %         % % %    .......          %
% %%% %%%%%%%%% % % %%%%%%%%%.%%%%%%%%%%%
%     %         % %     %    .....%.    %
%%%%%%%%% %%%%%%% %%%%%%%%% %%%%%.%.%%%%%
%             %         %       %.......%
% %%% %%%%%%%%% %%%%% %%%%% % % % %%% %.%
%   %             %   %         %     %.%
%%%%%%%%%%%%%%%%%%%%%%%%%%%%%%%%%%%%%%%%%
