%%%%%%%%%%%%%%%%%%%%%%%%%%%%%%%%%%%%%%%%%
%.%...........%.............%...........%
%.%%%%%.%%%%%.%%%.%%%%%.%%%.%.%%%.%%%%%%%
%.........%.........%...%.......%.......%
%%%%%%%%%.%%%%%.%%%%%%%.%.%.%%%%%%%%%.%%%
%     %.....%...%.........%.....%...%...%
% %%% %.%%%.%.%%%.%%%%%%%%%.%%%%%.%%%%%.%
%   %     % %...............%.........%.%
% % %%% %%%%%%%.%%%%%%%%%.%%%.%.%%%%%%%.%
% %   %     %.....%...%...%...%.........%
%%% %%%%%%%%%%%%%%%.%.%.%%%.%%%%%%%%%%%%%
%     %         %...%.%...%.............%
%%% %%%%% %%%%%.%.%.%%%.%%%%%%%%%%%%%%%.%
%   %         %.%.%.....................%
% %%% %%%%%%%%%.%.%.%%%%%%%%%.%%%%%%%%%%%
%     %.........%.%.....%.........%.....%
%%%%%%%%%.%%%%%%%.%%%%%%%%%.%%%%%.%.%%%%%
%.............%.........%.......%.......%
%.%%%.%%%%%%%%%.%%%%%.%%%%%.%.%.%.%%%.%.%
%...%.............%...%.........%.....%.%
%%%%%%%%%%%%%%%%%%%%%%%%%%%%%%%%%%%%%%%%%
