%%%%%%%%%%%%%%%%%%%%%%%
%.......%.....%.....%.%
%%%.%.%%%%%.%.%%%.%.%.%
%.%.%.......%...%.%...%
%.%.%.%.%%%.%%%.%.%%%.%
%.....%...%.........% %
%.%%%.%.%.%.%.%.%%%%%.%
%.%.%...%.%.%.......%.%
%.%.%.%%%.%%%%%.%.%%%.%
%...%.........%.%.....%
%%%%%%%%%%%%%%%%%%%%%%%
