%%%%%%%%%%%%%%%%%%%%%%%%%%%%%%%%%%%%%%%%%
%.%           %             %...........%
%.%%%%% %%%%% %%% %%%%% %%% %.%%%.%%%%%%%
%.........%         %   %  .....%.......%
%%%%%%%%%.%%%%% %%%%%%% % %.%%%%%%%%%.%%%
%.....%.....%   %         %.    %   %...%
%.%%%.%.%%%.% %%% %%%%%%%%%.%%%%% %%%%%.%
%...%.....%.%            ...%...      %.%
%.%.%%%.%%%%%%% %%%%%%%%%.%%%.%.%%%%%%%.%
%.%...%.....%     %   %...%...%.........%
%%%.%%%%%%%%%%%%%%% % %.%%%.%%%%%%%%%%%%%
%.....%  .......%...% %.  %.............%
%%%.%%%%%.%%%%%.%.%.%%%.%%%%%%%%%%%%%%%.%
%...%.........%.%.%......... ...........%
%.%%%.%%%%%%%%%.%.%.%%%%%%%%%.%%%%%%%%%%%
%.....%  .......%.%.....%.........%.....%
%%%%%%%%%.%%%%%%%.%%%%%%%%%.%%%%%.%.%%%%%
%    .........%.........%.......%... ...%
% %%%.%%%%%%%%%.%%%%%.%%%%%.%.%.%.%%%.%.%
%   %.............%...%.........%.....%.%
%%%%%%%%%%%%%%%%%%%%%%%%%%%%%%%%%%%%%%%%%
