%%%%%%%%%%%%%%%%%%%%%%%%%%%%%%%%%%%%%
%.....................%..           %
%.....................%...          %
%.....................%....         %
%.....................%.....        %
%.....................%......       %
%.......%%%%%%%%%%%%%%%....%.       %
%..........................%.       %
%..........................%.       %
%..........................%.       %
%..........................%.       %
%..........................%.       %
%....%%%%%%%%%%%%%%%%%%%%%%%.       %
%........%                ...       %
%........%    ...............       %
%........%    ....... .......       %
%........%...........   .....       %
%........%.  ... ........ ...       %
%........%.  ......... . ....       %
%%%%%%%%%%%%%%%%%%%%%%%%%%%%%%%%%%%%%
