%%%%%%%%%%%%%%%%%%%%%%%%%%%%%%%%%%%%%
%                    .%.............%
%                    .%.............%
%                    .%.............%
%                    .%...   .......%
%      ...............%.. ... ......%
%      .%%%%%%%%%%%%%%%   .%. ......%
%      . ..................%. ......%
%      . .                 %. ......%
%      . ..................%. ......%
%      .                  .%. ......%
%      ....................%. ......%
%    %%%%%%%%%%%%%%%%%%%%%%%. ......%
%        %                  . ......%
%        %                  . ......%
%        %                  . ......%
%        %                  . ......%
%        %                  . ......%
%        %..........................%
%%%%%%%%%%%%%%%%%%%%%%%%%%%%%%%%%%%%%
