%%%%%%%%%%%%%%%%%%%%%%%
%       %.....%.....%.%
%%% % %%%%% %.%%%.%.%.%
% % %  .....%...%.%...%
% % % %.%%%.%%%.%.%%%.%
%.....%...%... .....%.%
%.%%%.%.%.%.%.% %%%%%.%
%.%.%. .%.%.%.....  %.%
%.%.%.%%%.%%%%%.%.%%%.%
%...%.........%.%.....%
%%%%%%%%%%%%%%%%%%%%%%%
