%%%%%%%%%%%%%%%%%%%%%%%%%%%%%%%%%%%%%
%.....................%..           %
%.....................%..           %
%.....................%....         %
%.....................%....         %
%.....................%......       %
%.......%%%%%%%%%%%%%%%....%.       %
%..........................%.       %
%..........................%.       %
%..........................%.       %
%..........................%.       %
%..........................%.       %
%....%%%%%%%%%%%%%%%%%%%%%%%.       %
%........%...................       %
%........%.                         %
%........%.                         %
%........%.                         %
%........%.                         %
%........%.                         %
%%%%%%%%%%%%%%%%%%%%%%%%%%%%%%%%%%%%%
