%%%%%%%%%%%%%%%%%%%%%%%%%%%%%%%%%%%%%%%%%
%.%...........%.............%.          %
%.%%%%%.%%%%%.%%%.%%%%%.%%%.%.%%% %%%%%%%
%.......  %.......  %...%.....  %       %
%%%%%%%%% %%%%%.%%%%%%%.%.%.%%%%%%%%% %%%
%     %     %...%..... ...%...  %   %   %
% %%% % %%% %.%%%.%%%%%%%%%.%%%%% %%%%% %
%   %     % %...............%         % %
% % %%% %%%%%%%.%%%%%%%%%.%%% % %%%%%%% %
% %   %     %.....%...%...%   %         %
%%% %%%%%%%%%%%%%%%.%.%.%%% %%%%%%%%%%%%%
%     %         %...%.%...%             %
%%% %%%%% %%%%% %.%.%%%.%%%%%%%%%%%%%%% %
%   %         % %.%.................    %
% %%% %%%%%%%%% %.%.%%%%%%%%%.%%%%%%%%%%%
%     %         %.%.....%.........%.....%
%%%%%%%%% %%%%%%%.%%%%%%%%%.%%%%%.%.%%%%%
%             %...      %.......%.......%
% %%% %%%%%%%%% %%%%% %%%%%.%.% %.%%%.%.%
%   %             %   %.......  %.....%.%
%%%%%%%%%%%%%%%%%%%%%%%%%%%%%%%%%%%%%%%%%
