%%%%%%%%%%%%%%%%%%%%%%%
%  .....%  ...%  ...%.%
%%%.%.%%%%%.%.%%%.%.%.%
%.%.%.......%...%.%...%
%.%.% % %%% %%%.%.%%% %
%...  %   %    ...  % %
%.%%% % % % % % %%%%% %
%.% %   % % %       % %
%.% % %%% %%%%% % %%% %
%.  %         % %     %
%%%%%%%%%%%%%%%%%%%%%%%
