%%%%%%%%%%%%%%%%%%%%%%%%%%%%%%%%%%%%%
%.....................%.............%
%.....................%.............%
%.....................%.............%
%.....................%.............%
%.....................%.............%
%.......%%%%%%%%%%%%%%%....%........%
%..........................%........%
%..........................%........%
%..........................%........%
%..........................%........%
%..........................%........%
%....%%%%%%%%%%%%%%%%%%%%%%%........%
%........%..........................%
%........%..........................%
%........%..........................%
%........%..........................%
%........%..........................%
%........%..........................%
%%%%%%%%%%%%%%%%%%%%%%%%%%%%%%%%%%%%%
