%%%%%%%%%%%%%%%%%%%%%%%%%%%%%%%%%%%%%%%%%
%       %.....%       % %     % %   %.%.%
% % %%% %.%%%.%%% %%%%% % %%%%% % %%%.%.%
% %   % %...%...%...%.......% %.........%
%%%%%%% %%%.%%%.%.%.%.%.%.%%% %.%%%.%.%.%
%   %.........%...%.%.%.%.%.....% %.%.%.%
% %%%.%.%%%.%%%%%%%.%.%%%.%.%%%%% %.%%%.%
% %...%...%...%.%...%...%...%.%  ...%...%
% %.%%%.%.%%%%%.%.%%%%%.%%%%%.%%%.%%%%%%%
%  .%...%.%.....%.%.....%   %.......%...%
%%%.%%%%%%%%%.%%%.%.%%%.%%% %%%%%%%.%%%.%
%  ...% %   %.....%.%.%.%.%  .......%...%
%%%%%.% % %%%%%%%.%.%.%%%.%%%.%%%.%%%.%.%
% %...%...  %   %...%...........%.%...%.%
% %.%%%.%.%%% %%%%%%%%%.%%%%%%%.%%%.%%%%%
%  .....%...  %       %.%     %...%.....%
% %%%%%%%%%.%%%%% %%%%%.%%%%% %.%.%%%.%%%
% %   % %  ...    %.%.%...%   %.%.....% %
% % % % %%%%%.%%%%%.%.%%%.% % %%%.%.%%%%%
% % %       %.  % %.....%.%.......%.% % %
% % %%% % %%%.%%% %%%%%.%.%.%%%.%.%%% % %
%   % % % %  ...  %...%.%.%...%.%.%     %
%%% % %%%%%%%%%.%%%.%%%.%.%%%.%%%%%%% %%%
%     %.%...%...........%...%...........%
%%% % %.%.%%%.%%%.%%%%%.%.% %%%%%%%%%%%.%
%   % %...%  .  %...%...%.%.......%  ...%
%%% %%%.%%%%%.% %%%.%.%%%.%.%%%%%.%%%.%.%
%     %...%  ...  %.%...%.%.% % %.....%.%
% % % %.%%%%%.%.%%%%%%%%%%%.% % %%%%%%%.%
% % % %.....%.%...........%...%.......%.%
% %%% %%%.%.%%%%%.%.%%%%%.%%%.%.%.%%%%%%%
%   % %...%.......%.%...%...%...%.....%.%
% %%%%%%%.%%%%%.%%%%%.%.%%%.%%%.%%%.%.%.%
%   %.....%   %.%.....%.......%.%...%...%
% % %%%%%%%%%%%.%.%.%%%%%.%.%.%.%%%%%.%%%
% %   %.......%.%.%.....%.%.%.%...%.....%
% %%%%%.%.%%%%%%%.%%%.%%%%%%%.%%%.%.%%%.%
%   %...%.....%  .%...%.....%.%...%.% %.%
%%%%%.%.%%%.%%%%%.%%%%%.%%%.%.%%%.%.% %%%
%.....%.%.................%.%...%.%.....%
%%%%%%%%%%%%%%%%%%%%%%%%%%%%%%%%%%%%%%%%%
