%%%%%%%%%%%%%%%%%%%%%%%
%.......%.....%.....%.%
%%%.%.%%%%%.%.%%%.%.%.%
%.%.%.......%...%.%...%
%.%.%.%.%%%.%%%.%.%%% %
%.....%...%.........% %
%.%%%.%.%.%.%.%.%%%%% %
%.%.%...% % %. .....% %
%.%.%.%%% %%%%% % %%% %
%...%.....    % %     %
%%%%%%%%%%%%%%%%%%%%%%%
