%%%%%%%%%%%%%%%%%%%%%%%%%%%%%%%%%%%%%%%%%
%.......%.....%.......%.%.....%.%...%.%.%
%.%.%%%.%.%%%.%%%.%%%%%.%.%%%%%.%.%%%.%.%
%.%...%.%...%...%...%.......%.%.........%
%%%%%%%.%%%.%%%.%.%.%.%.%.%%%.%.%%%.%.%.%
%...%.........%...%.%.%.%.%.....%.%.%.%.%
%.%%%.%.%%%.%%%%%%%.%.%%%.%.%%%%%.%.%%%.%
%.%...%...%...%.%...%...%...%.%.....%...%
%.%.%%%.%.%%%%%.%.%%%%%.%%%%%.%%%.%%%%%%%
%...%...%.%.....%.%.....%...%.......%...%
%%%.%%%%%%%%%.%%%.%.%%%.%%%.%%%%%%%.%%%.%
%.....%.%...%.....%.%.%.%.%.........%...%
%%%%%.%.%.%%%%%%%.%.%.%%%.%%%.%%%.%%%.%.%
%.%...%.....%...%...%...........%.%...%.%
%.%.%%%.%.%%%.%%%%%%%%%.%%%%%%%.%%%.%%%%%
%.......%.....%.......%.%.....%...%.....%
%.%%%%%%%%%.%%%%%.%%%%%.%%%%%.%.%.%%%.%%%
%.%...%.%.........%.%.%...%...%.%.....% %
%.%.%.%.%%%%%.%%%%%.%.%%%.%.%.%%%.%.%%%%%
%.%.%.......%...%.%.....%.%.......%.%.%.%
%.%.%%%.%.%%%.%%%.%%%%%.%.%.%%%.%.%%%.%.%
%...%.%.%.%.......%...%.%.%...%.%.%.....%
%%%.%.%%%%%%%%%.%%%.%%%.%.%%%.%%%%%%%.%%%
%.....%.%...%...........%...%...........%
%%%.%.%.%.%%%.%%%.%%%%%.%.%.%%%%%%%%%%%.%
%...%.%...%.....%...%...%.%.......%.....%
%%%.%%%.%%%%%.%.%%%.%.%%%.%.%%%%%.%%%.%.%
%.....%...%.......%.%...%.%.%.%.%.....%.%
%.%.%.%.%%%%%.%.%%%%%%%%%%%.%.%.%%%%%%%.%
%.%.%.%.....%.%...........%...%.......%.%
%.%%%.%%%.%.%%%%%.%.%%%%%.%%%.%.%.%%%%%%%
%...%.%...%.......%.%...%...%...%.....%.%
%.%%%%%%%.%%%%%.%%%%%.%.%%%.%%%.%%%.%.%.%
%...%.....%   %.%.....%.......%.%...%...%
%.%.%%%%%%%%%%%.%.%.%%%%%.%.%.%.%%%%%.%%%
%.%...%.......%.%.%.....%.%.%.%...%.....%
%.%%%%%.%.%%%%%%%.%%%.%%%%%%%.%%%.%.%%%.%
%...%...%.....%...%...%.....%.%...%.%.%.%
%%%%%.%.%%%.%%%%%.%%%%%.%%%.%.%%%.%.%.%%%
%.....%.%.................%.%...%.%.....%
%%%%%%%%%%%%%%%%%%%%%%%%%%%%%%%%%%%%%%%%%
