%%%%%%%%%%%%%%%%%%%%%%%%%%%
%%%%%%%%%%%%%%%%%%%%%%%%%%%
%%% .  ......%%%.........%%
%%  %........%.%.........%%
%% ...%......%%%.........%%
%%. ....%....%%%%%%%%%%%%%%
%% .....%%%%.%%%%%%%%.%%%%%
%%.  ...%%%%.%%%%%%%%%%%%%%
%%...%%.%%%% .%%.........%%
%% ..%%.%%%% .%%.%%%%%%%.%%
%%.%%.. %%%%. %%.........%%
%%...%% %%%%..%%%%%%%%%%%%%
%%.. %%.%%%% .%%%%%%%%%.%%%
%%...%% %%%%..%%%%%%%%%%%%%
%%. ....%%%%........  . .%%
%%. ....%%.%.....  ..%%%.%%
%%.....%. .......... %%% %%
%%%%%%%%%%%%%%%%%%%%.% % %%
%%%%%%%%%%%%.%%%%%%% %%% %%
%%%%%%%%%%%%%%%%%%%%     %%
%%   . .%. .%.           %%
%%  .. %..%%  %          %%
%%    ..% . %            %%
%%%%%%%%%%%%%%%%%%%%%%%%%%%
