%%%%%%%%%%%%%%%%%%%%%%%%%%%
%%%%%%%%%%%%%%%%%%%%%%%%%%%
%%%          %%%..    .. %%
%%  %        %.%.. ..... %%
%%    %     .%%%........ %%
%%      % .  %%%%%%%%%%%%%%
%%      %%%%.%%%%%%%%.%%%%%
%%      %%%% %%%%%%%%%%%%%%
%%   %% %%%% .%%........ %%
%%   %% %%%%  %%.%%%%%%% %%
%% %%   %%%%. %%........ %%
%%   %% %%%%  %%%%%%%%%%%%%
%%...%%.%%%% .%%%%%%%%% %%%
%%...%% %%%%  %%%%%%%%%%%%%
%%......%%%%.            %%
%%......%%.%         %%% %%
%%.....%.. .         %%% %%
%%%%%%%%%%%%%%%%%%%% % % %%
%%%%%%%%%%%%.%%%%%%% %%% %%
%%%%%%%%%%%%%%%%%%%%     %%
%% .....%  .%            %%
%% ... % .%%  %          %%
%% ...  %   %            %%
%%%%%%%%%%%%%%%%%%%%%%%%%%%
