%%%%%%%%%%%%%%%%%%%%%%%%%%%
%%%%%%%%%%%%%%%%%%%%%%%%%%%
%%%..........%%%.........%%
%%..%........%.%.........%%
%%....%......%%%.........%%
%%......%....%%%%%%%%%%%%%%
%%......%%%%.%%%%%%%%.%%%%%
%%......%%%%.%%%%%%%%%%%%%%
%%...%%.%%%%..%%.........%%
%%...%%.%%%%..%%.%%%%%%%.%%
%%.%%.. %%%%..%%.........%%
%%...%%.%%%%..%%%%%%%%%%%%%
%%...%%.%%%%..%%%%%%%%%.%%%
%%...%%.%%%%..%%%%%%%%%%%%%
%%......%%%%.............%%
%%......%%.%.........%%%.%%
%%.....%.............%%%.%%
%%%%%%%%%%%%%%%%%%%%.%.%.%%
%%%%%%%%%%%%.%%%%%%%.%%%.%%
%%%%%%%%%%%%%%%%%%%%.....%%
%% . ...%...%............%%
%%  .. %..%%..%..........%%
%% .  ..% ..%............%%
%%%%%%%%%%%%%%%%%%%%%%%%%%%
