%%%%%%%%%%%%%%%%%%%%%%%%%%%
%%%%%%%%%%%%%%%%%%%%%%%%%%%
%%%          %%%         %%
%%  %        % %    .    %%
%%    %      %%%      .  %%
%%      %    %%%%%%%%%%%%%%
%%      %%%% %%%%%%%%.%%%%%
%%      %%%% %%%%%%%%%%%%%%
%%   %% %%%%  %%      . .%%
%%   %% %%%%  %% %%%%%%%.%%
%% %%   %%%%  %%     ... %%
%%   %% %%%%  %%%%%%%%%%%%%
%%   %% %%%%  %%%%%%%%%.%%%
%%   %% %%%%  %%%%%%%%%%%%%
%%      %%%%          . .%%
%%      %% %        .%%%.%%
%%     %          .  %%% %%
%%%%%%%%%%%%%%%%%%%%.% % %%
%%%%%%%%%%%% %%%%%%% %%% %%
%%%%%%%%%%%%%%%%%%%% .   %%
%%      %   %    .       %%
%%  .  %. %%. % . .   .  %%
%%    . % . % . . . .   .%%
%%%%%%%%%%%%%%%%%%%%%%%%%%%
