%%%%%%%%%%%%%%%%%%%%%%%%%%%
%%%%%%%%%%%%%%%%%%%%%%%%%%%
%%%          %%%         %%
%%  %        % %    K    %%
%%    %      %%%         %%
%%      %    %%%%%%%%%%%%%%
%%      %%%% %%%%%%%% %%%%%
%%      %%%% %%%%%%%%%%%%%%
%%   %% %%%%  %%         %%
%%   %% %%%%  %% %%%%%%% %%
%% %%   %%%%  %%         %%
%%   %% %%%%  %%%%%%%%%%%%%
%%   %% %%%%  %%%%%%%%% %%%
%%   %% %%%%  %%%%%%%%%%%%%
%%      %%%%             %%
%%      %% %         %%% %%
%%     %             %%% %%
%%%%%%%%%%%%%%%%%%%% % % %%
%%%%%%%%%%%% %%%%%%% %%% %%
%%%%%%%%%%%%%%%%%%%%     %%
%%      %   %            %%
%%  .  %  %%  %          %%
%%      %   %            %%
%%%%%%%%%%%%%%%%%%%%%%%%%%%