%%%%%%%%%%%%%%%%%%%%%%%%%%%%%%%%%%%%%%%%%
%.%   ...   ..% ...  .......%......     %
%.%%%%%.%%%%%.%%%.%%%%%.%%%.%.%%%.%%%%%%%
%.........%.........%...%.......%.......%
%%%%%%%%%.%%%%%.%%%%%%%.%.%.%%%%%%%%%.%%%
%.....%.....%...%.........%.....%...%...%
%.%%%.%.%%%.%.%%%.%%%%%%%%%.%%%%%.%%%%%.%
%...%.....%.%...............%.........%.%
%.%.%%%.%%%%%%%.%%%%%%%%%.%%%.%.%%%%%%%.%
%.%...%.....%.....%...%...%...%.........%
%%%.%%%%%%%%%%%%%%%.%.%.%%%.%%%%%%%%%%%%%
%.....%.........%...%.%...%.............%
%%%.%%%%%.%%%%%.%.%.%%%.%%%%%%%%%%%%%%%.%
%...%.........%.%.%.....................%
%.%%%.%%%%%%%%%.%.%.%%%%%%%%%.%%%%%%%%%%%
%.....%.........%.%.....%.........%.....%
%%%%%%%%%.%%%%%%%.%%%%%%%%%.%%%%%.%.%%%%%
%.............%.........%.......%.......%
%.%%%.%%%%%%%%%.%%%%%.%%%%%.%.%.%.%%%.%.%
%...%.............%...%.........%.....%.%
%%%%%%%%%%%%%%%%%%%%%%%%%%%%%%%%%%%%%%%%%
