%%%%%%%%%%%%%%%%%%%%%%%%%%%%%%%%%%%%%%%%%
%.%...........%.............%...........%
%.%%%%%.%%%%%.%%%.%%%%%.%%%.%.%%%.%%%%%%%
%.........%.........%...%.......%.......%
%%%%%%%%%.%%%%%.%%%%%%% %.%.%%%%%%%%%.%%%
%     %.....%...%.........%.....%...%...%
% %%% %.%%%.%.%%%.%%%%%%%%%.%%%%%.%%%%%.%
%   %     %.%... ....... ...%.........%.%
% % %%% %%%%%%%.%%%%%%%%%.%%%.%.%%%%%%%.%
% %   %     %.....%...%...%...%.........%
%%% %%%%%%%%%%%%%%%.%.%.%%%.%%%%%%%%%%%%%
%     %         %...%.%...%.............%
%%% %%%%% %%%%% %.%.%%%.%%%%%%%%%%%%%%%.%
%   %         % %.%.....................%
% %%% %%%%%%%%% %.%.%%%%%%%%%.%%%%%%%%%%%
%     %         %.%.....%.........%.....%
%%%%%%%%% %%%%%%%.%%%%%%%%%.%%%%%.%.%%%%%
%             %         %  .    %.......%
% %%% %%%%%%%%% %%%%% %%%%%.% % %.%%%.%.%
%   %             %   %    .    %.. ..%.%
%%%%%%%%%%%%%%%%%%%%%%%%%%%%%%%%%%%%%%%%%
