%%%%%%%%%%%%%%%%%%%%%%%%%%%%%%%%%
% ...................... .....  %
% .......%%%%%%................ %
% .....%%.............%%%%%%%.%%%
% ....%.  ..........%%......... %
% ....%............%% ......... %
% ...% ............%........... %
% ...%.......... .%%..........  %
% ..%...... .....%%...........  %
%    %    .  ...  %%.. . ....   %
%    %             %            %
%     %            %%           %
%     %             %           %
%      %            %%          %
%      %              %%%%%%%%%%%
%       %                       %
%       %                       %
%       %                       %
%       %                       %
%%%%%%%%%%%%%%%%%%%%%%%%%%%%%%%%%
