%%%%%%%%%%%%%%%%%%%%%%%%%%%%%%%%%
%       ..............          %
%     ...%%%%%%      .........  %
%    ..%%             %%%%%%%.%%%
%    .%             %%........  %
%   ..%            %%..         %
%   .%             %..........  %
%  ..%            %%.           %
% ..%            %%..           %
%    %            %%.           %
%    %             %..          %
%     %            %%.          %
%     %             %..         %
%      %            %%........  %
%      %              %%%%%%%%%%%
%       %                       %
%       %                       %
%       %                       %
%       %                       %
%%%%%%%%%%%%%%%%%%%%%%%%%%%%%%%%%
