%%%%%%%%%%%%%%%%%%%%%%%%%%%%%%%%%
%   ................ ........   %
%  .. ...%%%%%%................ %
%  . ..%%.............%%%%%%%.%%%
% .. .% ............%%..........%
% . ..%............%%...........%
% . .%.............%............%
%  ..%............%%............%
% ..%............%%.............%
%    %  ..   .  . %%............%
%    %             %............%
%     %            %%...........%
%     %             %.......... %
%      %            %%... ....  %
%      %              %%%%%%%%%%%
%       %                       %
%       %                       %
%       %                       %
%       %                       %
%%%%%%%%%%%%%%%%%%%%%%%%%%%%%%%%%
